1111111111111111111111111
1E00000000110000000000001
1011110111110111110111101
1000000000000000000000001
1011101111011110111101111
1011101111011110111101111
10000000000000000000P0001
1111011110111110111101111
1111011110111110111101111
1000000000110000000000001
1111111111111111111111111