1111111111111111111111111
100P000000000000000000001
1011111111111111111111101
1000000000000000000000001
1011111011110111101111101
10000000CCC10111100000001
1111001111011110111C00111
1000000C000C00C000C000001
1011111111110111111111101
1000010E01000000000000001
1111111111111111111111111